Columns: 30
Rows: 20
343434343434343434343434343434
565656565656565656565656565656
340000000000000000000000000034
560000000000000000000000000056
340000000000000000000000000034
560000000000000000000000000056
340000000000000000000000000034
560000000000000000000000000056
340000000000000000000000000034
560000000000000000000000000056
340000000000000000000000000034
560000000000000000000000000056
340000000000000000000000000034
560000000000000000000000000056
340000000000000000000000000034
560000000000000000000000000056
340000000000000000000000000034
560000000000000000000000000056
343434343434343434343434343434
565656565656565656565656565656
